......................................................................................................................................................................................................................................................
......................................................................................................................................................................................................................................................
..............................C...............................................................................................................................................................C...........................................C...........
..........................................................C......................................C...........................C....................................C...................................................................................
............................................................................................................................................C.............................C............................C.........................C....................
........C.............C......................C..................C................................................C....................................................................................................................................
...............................................................................C.................................................C..............C...............................C.........................C............C.........................C....
..................................C.........................................................C.........................................................................................................................................................
......................................................................................................................................................................................................................................................
......................................................................................................................................................................................................................................................
......................................................................................................................................................................................................................................................
......................................................................................................................................................................................................................................................
......................................................................................................................................................................................................................................................
......................................................................................................................................................................................................................................................
.........................................................................................................................................111...1QQ1.................................................................b.................................
..........................Q.............................................................11111111111....111Q................Q.......................................................................................bb.................................
..................................................................................................................................................................................................................bbb.................................
.................................................................................................................................................................................................................bbbb.................................
..................Q.....1Q1Q1.......................................................1Q1...................1.....11.....Q...Q...Q.....1..........11.........b...b............bb   b...............11Q1...........bbbbb.................................
..........................................................................................................................................................bb...bb..........bbb   bb............................bbbbbb.................................
.........................................................................................................................................................bbb...bbb........bbbb   bbb..........................bbbbbbb.................................
..H.P.............h............G....t....G.....T.......Y..H..G.......Y.....................h............G.G.H..............G..G...h...G...G....GG.......bbbbH..bbbb......bbbbb   bbbb.h..t......G......G...t.bbbbbbbb.......F.........................
AAAAAAAAAAAAAAAAAAAAAAAAAAAAAAAAAAAAAAAAAAAAAAAAAAAAAAAAAAAAAAAAAAAAAAAAAAAAA  AAAAAAAAAAAAAAAAAAA   AAAAAAAAAAAAAAAAAAAAAAAAAAAAAAAAAAAAAAAAAAAAAAAAAAAAAAAAAAAAAAAAAAAAAAAAA   AAAAAAAAAAAAAAAAAAAAAAAAAAAAAAAAAAAAAAAAAAAAAAAAAAAAAAAAAAAAAAAAAAAAA
AAAAAAAAAAAAAAAAAAAAAAAAAAAAAAAAAAAAAAAAAAAAAAAAAAAAAAAAAAAAAAAAAAAAAAAAAAAAA  AAAAAAAAAAAAAAAAAAA   AAAAAAAAAAAAAAAAAAAAAAAAAAAAAAAAAAAAAAAAAAAAAAAAAAAAAAAAAAAAAAAAAAAAAAAAA   AAAAAAAAAAAAAAAAAAAAAAAAAAAAAAAAAAAAAAAAAAAAAAAAAAAAAAAAAAAAAAAAAAAAA